NO ./tests/textures/valid/north.xpm
SO ./tests/textures/valid/south.xpm
WE ./tests/textures/valid/west.xpm
EA ./tests/textures/valid/east.xpm
F 220,100,abc
C 225,30,0

1111
1N01
1111
