NO ./texture/koke_isirenga.xpm
SO ./texture/koke_maruisi.xpm
WE ./texture/kuro_isirenga.xpm
EA ./texture/isi.xpm

F 34,139,34
C 0,191,255

11111111111111111111111111111111111111111111111111
10000000000000000000000000000000000000000000000001
10000000000000000000000000000000000000000000000001
10000000000000000000000000000000000000000000000001
10000000000000000000000000000000000000000000000001
10000000000000000000000000000000000000000000000001
10000000000000000000000000000000000000000000000001
10000000000000000000000000000000000000000000000001
10000000000001111111111111111111111000000000000001
10000000000001000000000000000000001000000000000001
10000000000001000000000000000000001000000000000001
10000000000001000000000000000000001000000000000001
10000000000001000000000000000000001000000000000001
10000000000001000000000000000000001000000000000001
10000000000001000000000000000000001000000000000001
10000000000001000000000000000000001000000000000001
10000000000001000000000000000000001000000000000001
10000000000001000000000000000000001000000000000001
10000000000001000000000000000000001000000000000001
10000000000001000000000000000000001000000000000001
10000000000001000000000000000000001000000000000001
10000000000001000000000000000000001000000000000001
10000000000001000000000000000000001000000000000001
10000000000001000000000N00000000001000000000000001
10000000000001000000000000000000001000000000000001
10000000000001000000000000000000001000000000000001
10000000000001000000000000000000001000000000000001
10000000000001000000000000000000001000000000000001
10000000000001000000000000000000001000000000000001
10000000000001000000000000000000001000000000000001
10000000000001111111111111111111111000000000000001
10000000000000000000000000000000000000000000000001
10000000000000000000000000000000000000000000000001
10000000000000000000000000000000000000000000000001
10000000000000000000000000000000000000000000000001
10000000000000000000000000000000000000000000000001
10000000000000000000000000000000000000000000000001
10000000000000000000000000000000000000000000000001
11111111111111111111111111111111111111111111111111
