NO ./texture/koke_isirenga.xpm
SO ./texture/koke_maruisi.xpm
WE ./texture/kuro_isirenga.xpm
EA ./texture/isi.xpm

F 139,69,19
C 135,206,235

111111111111111111
100000000000000001
100000000000000001
100000000000000001
100000000000000001
100000000000000001
100000000000000001
100000000000000001
100000000000000001
100000000000000001
100000000000000001
100000000000000001
100000000000000001
100000000000000001
100000000000000001
100000000000000001
10000000W000000001
111111111111111111
