NO ./texture/koke_isirenga.xpm
SO ./texture/koke_maruisi.xpm
WE ./texture/kuro_isirenga.xpm
EA ./texture/isi.xpm

F 184,113,39
C 51,161,201

11111111111111111111111111111111111111111111
10000000000000000000000000000000000000000001
10000000000000000000000000000000000000000001
10000111100000000000000000000000000000000001
10000100100000000000000000000000000000000001
10000111100000000000000000000000000000000001
10000000000000000000000000000000000000000001
10000000000000000000000000000000000000000001
10000000000000000000000000000000000000000001
10000000000000111111100000000000000000000001
10000000000000100000100000000000000000000001
10000000000000100S00100000000000000000000001
10000000000000100000100000000000000000000001
10000000000000111111100000000000000000000001
10000000000000000000000000000000000000000001
10000000000000000000000000000000000000000001
10000000000000000000000000000000000000000001
10000000000000000000000000000000000000000001
10000000000000000000000000000000000000000001
11111111111111111111111111111111111111111111
