NO ./texture/koke_isirenga.xpm
SO ./texture/koke_maruisi.xpm
WE ./texture/kuro_isirenga.xpm
EA ./texture/isi.xpm

F 128,128,128
C 64,64,255

1111111111111111111111111111
1000000000000000000000000001
1000000000000000000000000001
1000000110000011000001100001
1000000110000011000001100001
1000000110000011000001100001
1000000000000000000000000001
1000000000000000000000000001
1000000110000011000001100001
1000000110000011000001100001
1000000110000011000001100001
1000000000000000000000000001
1000000000000E00000000000001
1000000110000011000001100001
1000000110000011000001100001
1000000110000011000001100001
1000000000000000000000000001
1000000000000000000000000001
1111111111111111111111111111
