NO ./texture/koke_isirenga.xpm
SO ./texture/koke_maruisi.xpm
WE ./texture/kuro_isirenga.xpm
EA ./texture/isi.xpm

F 255,0,0
C 0,255,0

1111111111111
1000000000001
1011101110101
1000001000101
1010001010001
1010111010101
1000000000001
1001111111101
1000000000001
1011111111011
1000000S00001
1111111111111
