11111111111111111111111111
10000100000000000N00000001
10000100000000000000000001
10000100000000000000000001
10000100000000000000000001
10000100000000000000000001
10000000000000000000000001
10010000000000011111111111
10010000000000000000000001
10010000000000000000000001
10000000000000000000000001
10000000000010000000000001
11000000000010000000000001
10100000000010000000000001
10010000000010000000000001
10001100000010000000000001
10000000000010000000000001
10000000000010000000000001
10000000000010000000000001
10000000000010000000000001
10000000000010000000000001
11111111111111111111111111
