1111111111111
1000010000001
1000010000001
1000000000001
1010000W11001
1000000000001
1111110000001
1000000000001
1000000000001
1000000000001
1111111111111
