1111111111111
1001000000001
1000000000001
1000000000001
1000000000001
10000N0000001
1000000000001
1000000000001
1000000000001
1000000000001
1111111111111
