1111111111111
1001000100001
1000000101111
1000000100001
1011111111001
10000N0000001
1111000000001
1000010111111
1001000000001
1001000000001
1111111111111
