NO ./texture/isi.xpm
SO ./texture/isi.xpm
WE ./texture/isi.xpm
EA ./texture/isi.xpm
F 220,100,0
C 225,30,0

11111111111111111111111111111111111111111111111111111111111111111111111111111111111111111111111111111
